00000000
01111110
01PC0110
0100E110
01111110
00000000