11111111111111111111111
1P0T000C100000001100C11
1010111011101110000T011
1C001T0C001000011111111
10111101111101111100011
100000C00000C0000000111
1T110111011111011110011
10000100C000010C0001C11
1011T101111111T11110011
10C00100C000010C0000001
1011011101111101111ET01
11111111111111111111111


